111101111
100000001
100000001
100000001
121111121